#0090
<MNA<CMU0008<FAI0000
<END

#0100
<PRI<FAO0004<TRA0099:0091:0010:0023

#0110
<PRI<FAO0004<TRA0101:0090:0001:0009

#0125
<FLJ3400:0126
<PRI<SOU0022<CNP0125:0021:0000<CMU0016
<MSG<GIT1006Got a =Life Capsule=!<WAI0160<NOD<RMU<ML+0001<FL+3400
Max health increased by 1!<NOD<END

#0126
<PRI<MSGIt's empty.<NOD
<END


#0150
<DNP0150
<QUA0025<SOU0026
<WAI0050
<QUA0035<SOU0026
<WAI0050
<QUA0045<SOU0026
<END

#0151
<DNP0151
<KEY
<MM0
<QUA00190<SOU0026
<WAI0050
<CMP0029:0005:0000<CMP0030:0005:0000<CMP0031:0005:0000<CMP0032:0005:0000<CMP0033:0005:0000
<CMP0029:0006:0041
<CMP0030:0006:0041
<CMP0031:0006:0041
<CMP0032:0006:0041
<CMP0033:0006:0041
<CMP0029:0007:0001
<CMP0030:0007:0001
<CMP0031:0007:0001
<CMP0032:0007:0001
<CMP0033:0007:0001
<CMP0029:0008:0041
<CMP0030:0008:0041
<CMP0031:0008:0041
<CMP0032:0008:0041
<CMP0033:0008:0041
<WAI0005
<PRI<MSG!!!<NOD<CLO
<FRE
<CMP0029:0006:0000
<CMP0030:0006:0000
<CMP0031:0006:0000
<CMP0032:0006:0000
<CMP0033:0006:0000
<CMP0029:0007:0041
<CMP0030:0007:0041
<CMP0031:0007:0041
<CMP0032:0007:0041
<CMP0033:0007:0041
<CMP0029:0008:0001
<CMP0030:0008:0001
<CMP0031:0008:0001
<CMP0032:0008:0001
<CMP0033:0008:0001
<CMP0029:0009:0041
<CMP0030:0009:0041
<CMP0031:0009:0041
<CMP0032:0009:0041
<CMP0033:0009:0041
<WAI0001
<CMP0029:0007:0000
<CMP0030:0007:0000
<CMP0031:0007:0000
<CMP0032:0007:0000
<CMP0033:0007:0000
<CMP0029:0008:0041
<CMP0030:0008:0041
<CMP0031:0008:0041
<CMP0032:0008:0041
<CMP0033:0008:0041
<CMP0029:0009:0001
<CMP0030:0009:0001
<CMP0031:0009:0001
<CMP0032:0009:0001
<CMP0033:0009:0001
<CMP0029:0010:0041
<CMP0030:0010:0041
<CMP0031:0010:0041
<CMP0032:0010:0041
<CMP0033:0010:0041
<WAI0001
<CMP0029:0008:0000
<CMP0030:0008:0000
<CMP0031:0008:0000
<CMP0032:0008:0000
<CMP0033:0008:0000
<CMP0029:0009:0041
<CMP0030:0009:0041
<CMP0031:0009:0041
<CMP0032:0009:0041
<CMP0033:0009:0044
<CMP0029:0010:0001
<CMP0030:0010:0001
<CMP0031:0010:0001
<CMP0032:0010:0001
<CMP0033:0010:0001
<CMP0029:0011:0041
<CMP0030:0011:0041
<CMP0031:0011:0041
<CMP0032:0011:0041
<CMP0033:0011:0041
<WAI0001
<CMP0029:0009:0000
<CMP0030:0009:0000
<CMP0031:0009:0000
<CMP0032:0009:0000
<CMP0033:0009:0000
<CMP0029:0010:0041
<CMP0030:0010:0041
<CMP0031:0010:0041
<CMP0032:0010:0041
<CMP0033:0010:0041
<CMP0029:0011:0001
<CMP0030:0011:0001
<CMP0031:0011:0001
<CMP0032:0011:0001
<CMP0033:0011:0001
<CMP0029:0012:0041
<CMP0030:0012:0041
<CMP0031:0012:0041
<CMP0032:0012:0041
<CMP0033:0012:0041
<WAI0001
<CMP0029:0010:0000
<CMP0030:0010:0000
<CMP0031:0010:0000
<CMP0032:0010:0000
<CMP0033:0010:0000
<CMP0029:0011:0041
<CMP0030:0011:0041
<CMP0031:0011:0041
<CMP0032:0011:0041
<CMP0033:0011:0041
<CMP0029:0012:0001
<CMP0030:0012:0001
<CMP0031:0012:0001
<CMP0032:0012:0001
<CMP0033:0012:0001
<CMP0029:0013:0041
<CMP0030:0013:0041
<CMP0031:0013:0041
<CMP0032:0013:0041
<CMP0033:0013:0041
<WAI0001
<CMP0029:0011:0000
<CMP0030:0011:0000
<CMP0031:0011:0000
<CMP0032:0011:0000
<CMP0033:0011:0000
<CMP0029:0012:0041
<CMP0030:0012:0041
<CMP0031:0012:0041
<CMP0032:0012:0041
<CMP0033:0012:0041
<CMP0029:0013:0001
<CMP0030:0013:0001
<CMP0031:0013:0001
<CMP0032:0013:0001
<CMP0033:0013:0001
<CMP0029:0014:0041
<CMP0030:0014:0041
<CMP0031:0014:0041
<CMP0032:0014:0041
<CMP0033:0014:0041
<WAI0001
<CMP0029:0012:0000
<CMP0030:0012:0000
<CMP0031:0012:0000
<CMP0032:0012:0000
<CMP0033:0012:0000
<CMP0029:0013:0041
<CMP0030:0013:0041
<CMP0031:0013:0041
<CMP0032:0013:0041
<CMP0033:0013:0041
<CMP0029:0014:0001
<CMP0030:0014:0001
<CMP0031:0014:0001
<CMP0032:0014:0001
<CMP0033:0014:0001
<CMP0029:0015:0041
<CMP0030:0015:0041
<CMP0031:0015:0041
<CMP0032:0015:0041
<CMP0033:0015:0041
<WAI0001
<CMP0029:0013:0000
<CMP0030:0013:0000
<CMP0031:0013:0000
<CMP0032:0013:0000
<CMP0033:0013:0000
<CMP0029:0014:0041
<CMP0030:0014:0041
<CMP0031:0014:0041
<CMP0032:0014:0041
<CMP0033:0014:0041
<CMP0029:0015:0001
<CMP0030:0015:0001
<CMP0031:0015:0001
<CMP0032:0015:0001
<CMP0033:0015:0001
<CMP0029:0016:0041
<CMP0030:0016:0041
<CMP0031:0016:0041
<CMP0032:0016:0041
<CMP0033:0016:0041
<WAI0001
<CMP0029:0014:0000
<CMP0030:0014:0000
<CMP0031:0014:0000
<CMP0032:0014:0000
<CMP0033:0014:0000
<CMP0029:0015:0041
<CMP0030:0015:0041
<CMP0031:0015:0041
<CMP0032:0015:0041
<CMP0033:0015:0041
<CMP0029:0016:0001
<CMP0030:0016:0001
<CMP0031:0016:0001
<CMP0032:0016:0001
<CMP0033:0016:0001
<CMP0029:0017:0041
<CMP0030:0017:0041
<CMP0031:0017:0041
<CMP0032:0017:0041
<CMP0033:0017:0041
<WAI0001
<CMP0029:0015:0000
<CMP0030:0015:0000
<CMP0031:0015:0000
<CMP0032:0015:0000
<CMP0033:0015:0000
<CMP0029:0016:0041
<CMP0030:0016:0041
<CMP0031:0016:0041
<CMP0032:0016:0041
<CMP0033:0016:0041
<CMP0029:0017:0001
<CMP0030:0017:0001
<CMP0031:0017:0001
<CMP0032:0017:0001
<CMP0033:0017:0001
<CMP0029:0018:0041
<CMP0030:0018:0041
<CMP0031:0018:0041
<CMP0032:0018:0041
<CMP0033:0018:0041
<WAI0001
<CMP0029:0016:0000
<CMP0030:0016:0000
<CMP0031:0016:0000
<CMP0032:0016:0000
<CMP0033:0016:0000
<CMP0029:0017:0041
<CMP0030:0017:0041
<CMP0031:0017:0041
<CMP0032:0017:0041
<CMP0033:0017:0041
<CMP0029:0018:0001
<CMP0030:0018:0001
<CMP0031:0018:0001
<CMP0032:0018:0001
<CMP0033:0018:0001
<CMP0029:0019:0041
<CMP0030:0019:0041
<CMP0031:0019:0041
<CMP0032:0019:0041
<CMP0033:0019:0041
<WAI0001
<CMP0029:0017:0000
<CMP0030:0017:0000
<CMP0031:0017:0000
<CMP0032:0017:0000
<CMP0033:0017:0000
<CMP0029:0018:0041
<CMP0030:0018:0041
<CMP0031:0018:0041
<CMP0032:0018:0041
<CMP0033:0018:0041
<CMP0029:0019:0001
<CMP0030:0019:0001
<CMP0031:0019:0001
<CMP0032:0019:0001
<CMP0033:0019:0001
<CMP0029:0020:0041
<CMP0030:0020:0041
<CMP0031:0020:0041
<CMP0032:0020:0041
<CMP0033:0020:0041
<WAI0001
<CMP0029:0018:0000
<CMP0030:0018:0000
<CMP0031:0018:0000
<CMP0032:0018:0000
<CMP0033:0018:0000
<CMP0029:0019:0041
<CMP0030:0019:0041
<CMP0031:0019:0041
<CMP0032:0019:0041
<CMP0033:0019:0041
<CMP0029:0020:0001
<CMP0030:0020:0001
<CMP0031:0020:0001
<CMP0032:0020:0001
<CMP0033:0020:0001
<CMP0029:0021:0041
<CMP0030:0021:0041
<CMP0031:0021:0041
<CMP0032:0021:0041
<CMP0033:0021:0041
<WAI0001
<CMP0029:0019:0000
<CMP0030:0019:0000
<CMP0031:0019:0000
<CMP0032:0019:0000
<CMP0033:0019:0000
<CMP0029:0020:0041
<CMP0030:0020:0041
<CMP0031:0020:0041
<CMP0032:0020:0041
<CMP0033:0020:0041
<CMP0029:0021:0001
<CMP0030:0021:0001
<CMP0031:0021:0001
<CMP0032:0021:0001
<CMP0033:0021:0001
<CMP0029:0022:0041
<CMP0030:0022:0041
<CMP0031:0022:0041
<CMP0032:0022:0041
<CMP0033:0022:0041
<WAI0001
<CMP0029:0019:0000
<CMP0030:0019:0000
<CMP0031:0019:0000
<CMP0032:0019:0000
<CMP0033:0019:0000
<CMP0029:0020:0000
<CMP0030:0020:0000
<CMP0031:0020:0000
<CMP0032:0020:0000
<CMP0033:0020:0000
<CMP0029:0021:0013
<CMP0030:0021:0014
<CMP0031:0021:0013
<CMP0032:0021:0014
<CMP0033:0021:0013
<CMP0029:0022:0029
<CMP0030:0022:0030
<CMP0031:0022:0029
<CMP0032:0022:0030
<CMP0033:0022:0029
<WAI0001
<CMP0029:0026:0041
<CMP0030:0026:0041
<CMP0031:0026:0041
<CMP0032:0026:0041
<CMP0033:0026:0041
<CMP0029:0027:0001
<CMP0030:0027:0001
<CMP0031:0027:0001
<CMP0032:0027:0001
<CMP0033:0027:0001
<CMP0029:0028:0041
<CMP0030:0028:0041
<CMP0031:0028:0041
<CMP0032:0028:0041
<CMP0033:0028:0041
<END
#0200